3 5
0 0 2 4
1 1 1 1 1
1 0 0 0 1
1 1 1 1 1
1 8 8 8 8
1 0 0 0 8
1 1 1 1 8
1 1 1 1 1
9 0 0 0 1
9 9 9 9 1